11111
10001
10001

11111
1P0C1
1E0E1
11111