11111111111111111111111111111111
10000000000000000000000000000001
10000000000000000000000000000001
10000000000000000000000000000001
10000000000000000E00000000000001
10000000000011111100000000000001
10000000000000000000000100000001
100000000P0000000000000100000001
10000000000000000000C00100000001
10000000000000000000000100000001
10000000000000000000000000000001
10000000000111111100000000000001
10000000000000000000000000000001
100000000000C0000000000000000001
10000000000000000000000000000001
100000000000000000C0000000000001
10000000000000000000000000000001
10000000000000000000000000000001
100000000C0000000000000000000001
10000000000000000000000000000001
10000000000000000000000000000001
11111111111111111111111111111111