111111111111111111111111111111111
100000000000000000000000000000001
100000000000000000000000000000001
100000000000000000000000000000001
10000000000000000E000E00000000001
100000000000111111000000000000001
100000000000000000000C01000000001
100000000P00000000000001000000001
10000000000000000000C001000000001
100000000000000000000001000000001
100000000000000000000000000000001
100000000001111111000000000000001
100000000000000000000000000000001
100000000000C00000000000000000001
100000000000000000000000000000001
100000000000000000C00000000000001
100000000000000000000000000000001
100000000000000000000000000000001
100000000C00000000000000000000001
100000000000000000000000000000001
100000000000000000000000000000001
111111111111111111111111111111111