111111111111111111111111111111111111111111111111111111111111111111111111
1000000000000000000000000000000000000000000000000000000000000000000000E1
10000000000000000P000000000000000000000000000000000000000000000000000001
100000000000000000000000000000000001000000000000C00000000000000000000001
1000000000000000000000000000000000010000000000000000C000000C000000000001
100000011111111111111111100000000001000000000000000000000000000000000001
100000000000000000000000000000000001000000000000000000000C00000000000001
10000000000000000C000000000000000001000111111111111110000000000000000001
100000000000000000000000000000000001000000000000000000000000000000000001
10000000000000000000000000C000000001000000000000C0C00C0CC000000000000001
100000011111111111111111100000000001000000000000000000000000000000000001
100000000000000000000000000000000001000000001111111111111000000000000001
1000000000000000000000000000000000010000000000000C0000000000000000000001
10000000000000000000000000C000000001000000000000000000000000000000000001
100000000000000000000000000000000001000000000000000000000000000000000001
100000000000000C00000000000000000001000000000000000000000000000000000001
100000000000000000000000000000000001000000000001111111111111111110000001
100000000000000000000000000000000001000000000000000000000000000000000001
100000011111111111111111100000000001000000000000000000000000000000000001
1000000000000000000000000000000000010000000000000C0000000000000000000001
100000000000000000000000000000000001000000000000000000000000000000000001
100000000000000000000000000000000001000000000000000000000000000000000001
100000000000000000000000C000000000010000000000C0000000000000000000000001
10000000000000C000000000000000000000000000000000000000000000000000000001
10000000000000000000000000000000000000C000000000000000000000000000000001
100000000000000000000000000000000000000000000000000000000000000000000001
101111111111111111111111111111111111111111111111111111111111111111111101
1000000000000000000C000000000000000000000C00000000000000000000C000000001
1E000000000000000000000000000C00000000000000000000000000C0000000000000E1
111111111111111111111111111111111111111111111111111111111111111111111111